e	e	e	e	e	e	e	e	e	e	e	e	e	e	e	e	e	e	e	e	e	e	e	e
e	e	e	e	e	e	e	e	e	e	e	e	e	e	e	e	e	e	e	e	e	e	e	e
x	x	x	x	x	x	x	x	x	x	x	x	x	x	x	x	x	x	x	x	x	x	x	x
x	x	x	x	x	x	x	x	x	x	x	x	x	x	x	x	x	x	x	x	x	x	x	x
x	x	x	x	x	x	x	x	x	x	e	e	e	e	e	x	x	x	x	x	x	x	x	x
x	x	x	x	x	x	x	x	x	x	e	e	e	e	e	x	x	x	x	x	x	x	x	x
x	x	x	x	x	x	x	x	x	x	e	e	e	e	e	x	x	x	x	x	x	x	x	x
x	x	x	x	x	x	x	x	x	x	e	e	e	e	e	x	x	x	x	x	x	x	x	x
x	x	x	x	x	x	x	x	x	x	e	e	e	e	e	x	x	x	x	x	x	x	x	x
x	x	x	x	x	x	x	x	x	x	x	e	e	e	x	x	x	x	x	x	x	x	x	x
x	x	x	x	e	e	e	e	e	e	e	e	e	e	e	e	e	e	e	e	x	x	x	x
x	x	x	x	e	x	x	x	x	x	x	e	e	e	x	x	x	x	x	e	x	x	x	x
x	x	x	x	e	x	x	x	x	x	x	x	e	x	x	x	x	x	x	e	x	x	x	x
x	x	x	x	e	x	x	x	x	x	x	x	e	x	x	x	x	x	x	e	x	x	x	x
x	x	x	x	e	x	x	x	x	x	x	x	e	x	x	x	x	x	x	e	x	x	x	x
x	x	x	x	e	x	x	x	x	x	x	x	e	x	x	x	x	x	x	e	x	x	x	x
x	x	x	x	e	x	x	x	x	x	x	x	e	x	x	x	x	x	x	e	x	x	x	x
x	x	x	x	e	x	x	x	x	x	x	x	e	x	x	x	x	x	x	e	x	x	x	x
x	x	x	x	e	x	x	x	x	x	x	x	e	x	x	x	x	x	x	e	x	x	x	x
x	x	x	e	e	e	x	x	x	x	x	e	e	e	x	x	x	x	e	e	e	x	x	x
x	x	x	e	e	e	x	x	x	x	x	e	e	e	x	x	x	x	e	e	e	x	x	x
x	x	x	e	e	e	x	x	x	x	x	e	e	e	x	x	x	x	e	e	e	x	x	x
x	x	x	x	x	x	x	x	x	x	x	x	x	x	x	x	x	x	x	x	x	x	x	x
x	x	x	x	x	x	x	x	x	x	x	x	x	x	x	x	x	x	x	x	x	x	x	x
x	x	x	x	x	x	x	x	x	x	x	x	x	x	x	x	x	x	x	x	x	x	x	x
x	x	x	x	x	x	x	x	x	x	x	x	x	x	x	x	x	x	x	x	x	x	x	x